XXXXX
X   X
X--3X
X   X
X   X
X   X
XXXXX
